############################
#............##............#
#.####.#####.##.#####.####.#
#O####.#####.##.#####.####O#
#.####.#####.##.#####.####.#
#..........................#
#.####.##.########.##.####.#
#.####.##.########.##.####.#
#......##....##....##......#
######.##### ## #####.######
######.##### ## #####.######
######.##    B     ##.######
######.## ###DD### ##.######
######.## #      # ##.######
WTTTTT.   #I P C #   .TTTTTW
######.## #      # ##.######
######.## ######## ##.######
######.##    $     ##.######
######.## ######## ##.######
######.## ######## ##.######
#............##............#
#.####.#####.##.#####.####.#
#.####.#####.##.#####.####.#
#O..##.......  .......##..O#
###.##.##.########.##.##.###
###.##.##.########.##.##.###
#......##....##....##......#
#.##########.##.##########.#
#.##########.##.##########.#
#..........................#
############################
